"filename", "language", "C++", "Markdown", "comment", "blank", "total"
"d:\DevelopTools\Code\Cpp\Tower-Of-Hanoi\FileOper\FileOper.cpp", "C++", 66, 0, 15, 4, 85
"d:\DevelopTools\Code\Cpp\Tower-Of-Hanoi\FileOper\FileOper.h", "C++", 18, 0, 6, 3, 27
"d:\DevelopTools\Code\Cpp\Tower-Of-Hanoi\GameLog\GameLog.cpp", "C++", 104, 0, 0, 19, 123
"d:\DevelopTools\Code\Cpp\Tower-Of-Hanoi\GameLog\GameLog.h", "C++", 42, 0, 16, 6, 64
"d:\DevelopTools\Code\Cpp\Tower-Of-Hanoi\MainMenu\MainMenu.cpp", "C++", 150, 0, 3, 11, 164
"d:\DevelopTools\Code\Cpp\Tower-Of-Hanoi\MainMenu\MainMenu.h", "C++", 25, 0, 2, 6, 33
"d:\DevelopTools\Code\Cpp\Tower-Of-Hanoi\PlayGame\PlayGame.cpp", "C++", 399, 0, 52, 23, 474
"d:\DevelopTools\Code\Cpp\Tower-Of-Hanoi\PlayGame\PlayGame.h", "C++", 30, 0, 8, 3, 41
"d:\DevelopTools\Code\Cpp\Tower-Of-Hanoi\README.md", "Markdown", 0, 4, 0, 4, 8
"d:\DevelopTools\Code\Cpp\Tower-Of-Hanoi\Tower\Tower.cpp", "C++", 182, 0, 17, 14, 213
"d:\DevelopTools\Code\Cpp\Tower-Of-Hanoi\Tower\Tower.h", "C++", 34, 0, 9, 8, 51
"d:\DevelopTools\Code\Cpp\Tower-Of-Hanoi\main.cpp", "C++", 7, 0, 0, 3, 10
"Total", "-", 1057, 4, 128, 104, 1293